##############################
######..######################
#####.....#####.##############
######...#.......#.###########
######...####.....#.##########
#######..##..........#########
###########.........##########
#########..####......#########
########...###......##########
#########..###.........#######
#########..............#######
########.......###.....#######
##..####.......##......#######
##..####.......##.....########
##...####.###...##....########
##.............#####.#########
###########..##.#####.########
#####.#####.....####...#######
###....###......####.....#####
###.....#.......#####....#####
##..............#.####..######
###................####.###.##
###................#####....##
######............########...#
######.............#######...#
#####...............######..##
######....##.........#####...#
#####....###..........####...#
#####..#####...##.....#####.##
##############################
